1 1 1 1 1 2 0 0 0 0 0 0 0 0 0 0 0 0 0 0 0 0 0 0 0 0 0 0 0 0 0 0 0 0 0 0 0 0 0 0 0 0 0
1 1 1 2 0 3 0 4 5 5 5 5 5 5 5 5 5 5 8 9 10 11 12 5 41 42 43 44 5 5 5 5 5 5 5 5 5 5 5 5 6 153 1
0 0 0 3 0 3 0 7 0 0 0 67 63 63 63 68 0 0 15 16 17 18 19 57 45 46 47 48 0 0 0 0 0 0 0 0 0 0 0 0 0 154 0
0 0 0 3 0 3 0 7 0 0 0 65 62 62 62 66 0 0 20 21 22 23 24 58 49 50 51 52 60 60 60 60 0 0 0 0 0 0 0 0 0 154 0
0 0 0 3 0 3 57 7 0 0 0 65 62 62 62 66 0 0 26 27 28 29 30 59 53 54 55 56 61 0 0 0 0 0 0 0 0 0 0 0 0 154 0
0 0 0 3 0 3 58 7 0 0 71 65 62 62 62 66 0 0 31 32 33 34 35 0 0 0 0 0 0 0 0 60 60 0 0 0 0 76 0 0 0 154 0
0 0 0 3 0 3 59 14 5 5 5 5 6 62 4 5 5 6 36 37 38 39 40 14 5 5 5 5 5 5 5 5 5 5 5 5 5 75 5 5 6 154 0 0 0 0 0 0
0 0 0 3 0 3 0 67 63 63 63 63 63 62 63 63 63 63 63 63 63 63 63 63 63 68 0 0 0 0 0 0 0 0 0 0 0 0 0 0 0 154 0 0 0 0 0 0 0
0 0 0 3 0 3 0 65 62 62 62 62 62 62 62 62 62 62 62 62 62 62 62 62 62 66 0 0 0 0 0 0 0 0 0 0 0 0 0 0 0 154 0 0 0 0 0 0
0 0 0 3 0 3 0 65 62 62 73 64 77 77 64 64 64 77 77 64 77 77 64 62 62 62 63 63 63 63 63 63 112 113 63 63 63 63 63 63 68 154 0 0 0 0 0 0 0
0 0 0 3 0 3 0 65 62 66 0 74 75 75 0 74 0 75 75 0 75 75 57 65 62 62 62 80 62 62 62 62 110 111 62 62 62 62 62 62 66 154 0 0 0 0 0 0 0
0 0 0 3 0 3 0 65 62 66 0 74 76 76 0 74 0 76 76 0 76 76 58 65 62 62 62 79 64 64 64 64 108 109 64 64 64 64 64 62 66 155 13 0 0 0 0 0
0 0 0 3 0 3 0 65 62 66 0 74 75 75 0 72 0 75 75 0 75 75 59 65 62 62 66 59 0 97 98 0 106 107 0 115 116 116 117 65 66 0 0 0 0 0 0 0 0
0 0 0 3 0 3 0 65 62 62 63 63 63 63 63 63 63 63 63 63 63 63 63 62 62 62 66 0 74 99 101 74 78 0 0 118 119 120 121 65 66 0 0 0 0 0 0 0 0
0 0 0 3 0 3 0 65 62 62 62 62 62 62 62 62 62 62 62 62 62 62 80 62 62 62 66 71 0 102 103 0 0 78 114 122 123 124 125 65 66 153 1 0 0 0 0 0 0
0 0 0 3 0 3 0 65 62 62 64 64 64 64 62 62 62 64 64 64 64 64 79 62 62 62 62 63 63 63 63 63 63 63 63 63 63 63 63 62 66 154 0 0 0 0 0 0 0
0 0 0 3 0 3 0 65 62 66 71 72 78 72 65 62 66 81 82 82 82 83 59 65 62 62 62 62 62 62 134 135 135 136 62 62 62 62 62 62 66 154 0 0 0 0 0 0 0
0 0 0 3 0 3 0 65 62 66 71 72 78 72 65 62 66 84 85 85 85 86 0 65 62 62 126 133 133 133 137 138 138 139 133 133 133 133 132 62 66 154 0 0 0 0 0 0 0
0 0 0 3 0 3 0 65 62 66 71 72 78 72 65 62 66 84 85 85 85 86 0 65 62 66 127 0 0 0 140 141 141 142 0 0 0 0 131 65 66 154 0 0 0 0 0 0 0
0 0 0 3 0 3 0 65 62 66 71 72 78 72 65 62 66 87 88 89 90 91 0 65 62 66 127 0 0 0 143 144 144 145 0 0 0 0 131 65 66 154 0 0 0 0 0 0 0
0 0 0 3 0 3 0 65 62 66 71 72 78 72 65 62 66 92 93 94 95 96 0 65 62 66 127 0 0 76 146 147 148 149 76 0 0 0 131 65 66 154 0 0 0 0 0 0 0
0 0 0 3 0 3 0 65 62 66 71 72 78 72 65 62 66 0 0 0 0 0 61 150 62 66 129 128 128 75 61 0 0 0 75 128 128 128 130 65 66 154 0 0 0 0 0 0 0
0 0 0 3 0 3 0 65 62 62 63 63 63 63 62 62 62 63 63 63 63 63 63 151 62 62 63 63 63 63 63 63 63 63 63 63 63 63 63 62 66 154 0 0 0 0 0 0 0
0 0 0 3 0 3 0 65 62 62 62 62 62 62 62 62 62 62 62 62 62 62 62 151 62 62 80 62 62 62 62 62 62 62 62 62 62 62 62 62 66 154 0 0 0 0 0 0 0
0 0 0 3 0 3 0 70 64 64 64 64 64 64 64 64 64 64 64 64 64 64 64 151 62 62 79 64 64 64 64 64 64 64 64 64 64 64 64 62 66 155 13 0 0 0 0 0 0
0 0 0 3 0 3 60 60 60 60 60 60 60 60 60 60 60 60 60 60 60 60 60 152 62 66 59 0 0 0 0 0 0 0 0 0 0 0 0 65 66 0 0 0 0 0 0 0 0
0 0 0 3 0 3 0 0 0 0 0 0 0 0 0 0 0 0 0 0 0 0 0 65 62 66 0 0 0 0 0 0 0 0 0 0 0 0 0 65 66 0 0 0 0 0 0 0 0
0 0 0 3 0 3 0 0 0 0 0 0 0 0 0 0 0 0 0 0 0 0 0 65 62 66 0 0 0 0 0 0 0 0 0 0 0 0 0 65 66 0 0 0 0 0 0 0 0
0 0 0 3 0 3 0 0 0 0 0 0 0 0 0 0 0 0 0 0 0 0 0 65 62 66 0 0 0 0 0 0 0 0 0 0 0 0 0 65 66 0 0 0 0 0 0 0 0
0 0 0 3 0 3 0 67 63 63 63 63 63 63 63 63 63 63 63 63 63 63 63 63 62 62 62 63 63 63 63 63 63 63 63 63 63 63 63 63 62 66 0 0 0 0 0 0 0 0
0 0 0 3 0 3 0 65 62 62 62 62 62 62 62 62 62 62 62 62 62 62 62 62 62 62 62 62 62 62 62 62 62 62 62 62 62 62 62 62 62 66 0 0 0 0 0 0 0 0
0 0 0 3 0 3 0 65 62 62 64 64 64 64 64 64 64 64 64 64 64 64 64 64 62 62 62 64 64 64 64 64 64 64 64 64 64 64 64 64 64 69 0 0 0 0 0 0 0 0
0 0 0 3 0 3 0 65 62 66 0 0 0 0 0 0 0 0 0 0 0 0 0 0 65 62 62 0 0 0 0 0 0 0 0 0 0 0 0 0 0 0 0 0 0 0 0 0 0 0
0 0 0 3 0 3 0 65 62 66 0 0 0 0 0 0 0 0 0 0 0 0 0 0 65 62 66 0 0 0 0 0 0 0 0 0 0 0 0 0 0 0 0 0 0 0 0 0 0 0
0 0 0 3 0 3 0 65 62 66 0 0 0 0 0 0 0 0 0 0 0 0 0 0 65 62 66 0 0 0 0 0 0 0 0 0 0 0 0 0 0 0 0 0 0 0 0 0 0 0
0 0 0 3 0 3 0 65 62 66 0 0 0 0 0 0 0 0 0 0 0 0 0 0 65 62 66 0 0 0 0 0 0 0 0 0 0 0 0 0 0 0 0 0 0 0 0 0 0 0
0 0 0 3 0 3 0 65 62 62 63 63 63 63 63 63 63 63 63 63 63 63 63 62 62 66 0 0 0 0 0 0 0 0 0 0 0 0 0 0 0 0 0 0 0 0 0 0 0
0 0 0 3 0 3 0 65 62 62 62 62 62 62 62 62 62 62 62 62 62 62 62 62 62 66 0 0 0 0 0 0 0 0 0 0 0 0 0 0 0 0 0 0 0 0 0 0 0 0
0 0 0 3 0 3 0 65 62 62 64 64 64 64 64 64 64 64 64 64 64 64 64 62 62 66 0 0 0 0 0 0 0 0 0 0 0 0 0 0 0 0 0 0 0 0 0 0 0
0 0 0 3 0 3 0 65 62 66 0 0 0 0 0 0 0 0 0 0 0 0 0 65 62 66 0 0 0 0 0 0 0 0 0 0 0 0 0 0 0 0 0 0 0 0 0 0 0
0 0 0 3 0 3 0 65 62 66 0 0 0 0 0 0 0 0 0 0 0 0 0 65 62 66 0 0 0 0 0 0 0 0 0 0 0 0 0 0 0 0 0 0 0 0 0 0 0
0 0 0 3 0 3 0 65 62 66 0 0 0 0 0 0 0 0 0 0 0 0 0 65 62 66 0 0 0 0 0 0 0 0 0 0 0 0 0 0 0 0 0 0 0 0 0 0 0
13 13 13 156 0 3 0 65 62 62 63 63 63 63 63 63 63 63 63 63 63 63 63 62 62 62 63 63 63 63 63 63 63 63 63 63 63 63 63 63 66 0 0 0 0 0 0 0 0
0 0 0 0 0 3 0 65 62 62 62 62 62 62 62 62 62 62 62 62 62 62 62 62 62 62 62 62 62 62 62 62 62 62 62 62 62 62 62 62 66 0 0 0 0 0 0 0 0
0 0 0 0 0 3 0 70 64 64 64 64 64 64 64 64 64 64 64 64 64 64 64 62 62 62 64 64 64 64 64 64 64 64 64 64 64 64 64 64 69 0 0 0 0 0 0 0 0
0 0 0 0 0 3 0 201 201 201 201 201 201 201 201 201 201 201 201 201 201 201 76 203 204 205 76 201 201 201 201 201 201 201 201 201 201 201 201 201 201 201 0 0 0 0
13 13 13 13 13 156 200 202 202 202 202 202 202 202 202 202 207 207 207 207 207 207 206 203 204 205 206 207 207 207 207 207 207 202 202 202 202 202 202 202 202 202 0 0 0
0 0 0 0 0 0 0 0 0 0 0 0 0 0 0 0 207 207 207 207 207 207 206 203 204 205 206 207 207 207 207 207 207 0 0 0 0 0 0 0 0 0 0 0 0
0 0 0 0 0 0 0 0 0 0 0 0 0 0 0 0 207 207 207 207 207 207 206 203 204 205 206 207 207 207 207 207 207 0 0 0 0 0 0 0 0 0 0 0 0 0 0 0 0 0 0 0 0 0 0 0 0 0 0 0 0 0 0 0 0 0 0 0 0 0 0 0 0 0 0 0 0 0 0 0 0 0 0 0 0 0 0 0 0 0 0 0
0 0 0 0 0 0 0 0 0 0 0 0 0 76 201 201 207 207 207 207 207 207 206 203 204 205 206 207 207 207 207 207 207 201 201 0 0 0 0 0 0 0 0 0 0 0 0 0 0 0 0 0 0 0 0 0 0 0 0 0 0 0 0 0 0 0 0 0 0 0 0 0 0 0 0 0 0 0 0 0 0 0 0 0 0 0 0 
0 0 0 0 0 0 0 0 0 0 0 0 0 76 207 207 207 207 207 207 207 207 206 203 204 205 206 207 207 207 207 207 207 207 207 0 0 0 0 0 0 0 0 0 0 0 0 0 0 0 0 0 0 0 0 0 0 0 0 0 0 0 0 0 0 0 0 0 0 0 0 0 0 0 0 0 0 0 0 0 0 0 0 0 0 0 0 
0 0 0 0 0 0 0 0 0 0 0 0 0 76 202 202 202 202 202 202 202 202 75 203 204 205 75 202 202 202 202 202 202 202 202 0 0 0 0 0 0 0 0 0 0 0 0 0 0 0 0 0 0 0 0 0 0 0 0 0 0 0 0 0 0 0 0 0 0 0 0 0 0 0 0 0 0 0 0 0 0 0 0 0 0 0 0 
0 0 0 0 0 0 0 0 0 0 0 0 0 76 208 208 208 208 208 208 208 208 208 203 204 209 210 211 212 210 210 213 214 215 0 0 0 0 0 0 0 0 0 0 0 0 0 0 0 0 0 0 0 0 0 0 0 0 0 0 0 0 0 0 0 0 0 0 0 0 0 0 0 0 0 0 0 0 0 0 0 0 0 0 0 0 0 
0 0 0 0 0 0 0 0 0 0 0 0 0 76 208 208 208 208 208 208 208 208 208 203 204 204 204 216 204 204 204 217 0 131 0 0 0 0 0 0 0 0 0 0 0 0 0 0 0 0 0 0 0 0 0 0 0 0 0 0 0 0 0 0 0 0 0 0 0 0 0 0 0 0 0 0 0 0 0 0 0 0 0 0 0 0 0 
0 0 0 0 0 0 0 0 0 0 0 0 0 76 208 208 208 208 208 208 208 208 208 203 204 218 219 220 219 219 219 221 0 131 0 0 0 0 0 0 0 0 0 0 0 0 0 0 0 0 0 0 0 0 0 0 0 0 0 0 0 0 0 0 0 0 0 0 0 0 0 0 0 0 0 0 0 0 0 0 0 0 0 0 0 0 0 
0 0 0 0 0 0 0 0 0 0 0 0 0 76 208 208 208 208 208 208 208 208 208 203 204 205 0 0 0 0 0 0 0 131 0 0 0 0 0 0 0 0 0 0 0 0 0 0 0 0 0 0 0 0 0 0 0 0 0 0 0 0 0 0 0 0 0 0 0 0 0 0 0 0 0 0 0 0 0 0 0 0 0 0 0 0 0 
0 0 0 0 0 0 0 0 0 0 0 0 0 76 222 210 210 210 210 210 210 210 210 223 204 205 0 0 0 0 0 0 0 131 0 0 0 0 0 0 0 0 0 0 0 0 0 0 0 0 0 0 0 0 0 0 0 0 0 0 0 0 0 0 0 0 0 0 0 0 0 0 0 0 0 0 0 0 0 0 0 0 0 0 0 0 0 
0 0 0 0 0 0 0 0 0 0 0 0 0 76 203 204 204 204 204 204 204 204 204 204 204 205 0 0 0 0 0 0 0 131 0 0 0 0 0 0 0 0 0 0 0 0 0 0 0 0 0 0 0 0 0 0 0 0 0 0 0 0 0 0 0 0 0 0 0 0 0 0 0 0 0 0 0 0 0 0 0 0 0 0 0 0 0 
0 0 0 0 0 0 0 0 0 0 0 0 0 76 224 219 219 219 219 219 219 219 219 219 225 209 210 213 0 0 0 0 0 131 0 0 0 0 0 0 0 0 0 0 0 0 0 0 0 0 0 0 0 0 0 0 0 0 0 0 0 0 0 0 0 0 0 0 0 0 0 0 0 0 0 0 0 0 0 0 0 0 0 0 0 0 0 
0 0 0 0 0 0 0 0 0 0 0 0 0 76 76 76 0 76 76 76 76 76 76 76 203 204 204 205 0 0 0 0 0 131 0 0 0 0 0 0 0 0 0 0 0 0 0 0 0 0 0 0 0 0 0 0 0 0 0 0 0 0 0 0 0 0 0 0 0 0 0 0 0 0 0 0 0 0 0 0 0 0 0 0 0 0 0 
0 0 0 0 0 0 0 0 0 0 0 0 0 76 76 76 0 76 76 0 0 0 0 0 203 204 204 205 0 0 0 0 0 131 0 0 0 0 0 0 0 0 0 0 0 0 0 0 0 0 0 0 0 0 0 0 0 0 0 0 0 0 0 0 0 0 0 0 0 0 0 0 0 0 0 0 0 0 0 0 0 0 0 0 0 0 0 
0 0 0 0 0 0 0 0 0 0 0 0 0 76 76 76 0 76 76 76 0 0 0 0 203 204 204 209 210 210 210 210 210 226 0 0 0 0 0 0 0 0 0 0 0 0 0 0 0 0 0 0 0 0 0 0 0 0 0 0 0 0 0 0 0 0 0 0 0 0 0 0 0 0 0 0 0 0 0 0 0 0 0 0 0 0 0 
0 0 0 0 0 0 0 0 0 0 0 0 0 76 76 76 0 76 76 76 0 0 0 0 224 219 219 219 219 219 219 219 227 228 0 0 0 0 0 0 0 0 0 0 0 0 0 0 0 0 0 0 0 0 0 0 0 0 0 0 0 0 0 0 0 0 0 0 0 0 0 0 0 0 0 0 0 0 0 0 0 0 0 0 0 0 0 
0 0 0 0 0 0 0 0 0 0 0 0 0 0 0 0 0 0 0 0 0 0 0 0 0 0 0 0 0 0 0 0 0 0 0 0 0 0 0 0 0 0 
0 0 0 0 0 0 0 0 0 0 0 0 0 0 0 0 0 0 0 0 0 0 0 0 0 0 0 0 0 0 0 0 0 0 0 0 0 0 0 0 0 0 0 
0 0 0 0 0 0 0 0 0 0 0 0 0 0 0 0 0 0 0 0 0 0 0 0 0 0 0 0 0 0 0 0 0 0 0 0 0 0 0 0 0 0 0 
0 0 0 0 0 0 0 0 0 0 0 0 0 0 0 0 0 0 0 0 0 0 0 0 0 0 0 0 0 0 0 0 0 0 0 0 0 0 0 0 0 0 0
0 0 0 0 0 0 0 0 0 0 0 0 0 0 0 0 0 0 0 0 0 0 0 0 0 0 0 0 0 0 0 0 0 0 0 0 0 0 0 0 0 0 0
0 0 0 0 0 0 0 0 0 0 0 0 0 0 0 0 0 0 0 0 0 0 0 0 0 0 0 0 0 0 0 0 0 0 0 0 0 0 0 0 0 0 0
0 0 0 0 0 0 0 0 0 0 0 0 0 0 0 0 0 0 0 0 0 0 0 0 0 0 0 0 0 0 0 0 0 0 0 0 0 0 0 0 0 0 0
0 0 0 0 0 0 0 0 0 0 0 0 0 0 0 0 0 0 0 0 0 0 0 0 0 0 0 0 0 0 0 0 0 0 0 0 0 0 0 0 0 0 0
0 0 0 0 0 0 0 0 0 0 0 0 0 0 0 0 0 0 0 0 0 0 0 0 0 0 0 0 0 0 0 0 0 0 0 0 0 0 0 0 0 0 0
0 0 0 0 0 0 0 0 0 0 0 0 0 0 0 0 0 0 0 0 0 0 0 0 0 0 0 0 0 0 0 0 0 0 0 0 0 0 0 0 0 0 0
0 0 0 0 0 0 0 0 0 0 0 0 0 0 0 0 0 0 0 0 0 0 0 0 0 0 0 0 0 0 0 0 0 0 0 0 0 0 0 0 0 0 0
0 0 0 0 0 0 0 0 0 0 0 0 0 0 0 0 0 0 0 0 0 0 0 0 0 0 0 0 0 0 0 0 0 0 0 0 0 0 0 0 0 0 0
0 0 0 0 0 0 0 0 0 0 0 0 0 0 0 0 0 0 0 0 0 0 0 0 0 0 0 0 0 0 0 0 0 0 0 0 0 0 0 0 0 0 0
0 0 0 0 0 0 0 0 0 0 0 0 0 0 0 0 0 0 0 0 0 0 0 0 0 0 0 0 0 0 0 0 0 0 0 0 0 0 0 0 0 0 0
0 0 0 0 0 0 0 0 0 0 0 0 0 0 0 0 0 0 0 0 0 0 0 0 0 0 0 0 0 0 0 0 0 0 0 0 0 0 0 0 0 0 0
0 0 0 0 0 0 0 0 0 0 0 0 0 0 0 0 0 0 0 0 0 0 0 0 0 0 0 0 0 0 0 0 0 0 0 0 0 0 0 0 0 0 0
0 0 0 0 0 0 0 0 0 0 0 0 0 0 0 0 0 0 0 0 0 0 0 0 0 0 0 0 0 0 0 0 0 0 0 0 0 0 0 0 0 0 0
0 0 0 0 0 0 0 0 0 0 0 0 0 0 0 0 0 0 0 0 0 0 0 0 0 0 0 0 0 0 0 0 0 0 0 0 0 0 0 0 0 0 0
0 0 0 0 0 0 0 0 0 0 0 0 0 0 0 0 0 0 0 0 0 0 0 0 0 0 0 0 0 0 0 0 0 0 0 0 0 0 0 0 0 0 0