680 680 680 680 680 680 680 680 680 680 680 680 680 680 680 680 680 680 680 680 680 680 680 680 680 680 680 680 680 680 680 680 680 680 680 680 680 680 680 680 680 680 680 680 680 680 680 680
680 680 680 680 680 680 680 680 680 680 680 680 680 680 680 680 680 680 680 680 680 680 680 680 680 680 680 680 680 680 680 680 680 680 680 680 680 680 680 680 680 680 680 680 680 680 680 680
680 680 680 680 680 680 680 680 680 680 680 680 680 680 680 680 680 680 680 680 680 680 680 680 680 680 680 680 680 680 680 680 680 680 680 680 680 680 680 680 680 680 680 680 680 680 680 680
680 680 680 680 680 680 680 680 680 680 680 680 680 680 680 680 680 680 680 680 680 680 680 680 680 680 680 680 680 680 680 680 680 680 680 680 680 680 680 680 680 680 680 680 680 680 680 680
680 680 680 680 680 680 680 680 680 680 680 680 680 680 680 680 680 680 680 680 680 680 680 680 680 680 680 680 680 680 680 680 680 680 680 680 680 680 680 680 680 680 680 680 680 680 680 680
680 680 680 680 680 680 680 680 680 680 680 680 680 680 680 680 680 680 680 680 680 680 680 680 680 680 680 680 680 680 680 680 680 680 680 680 680 680 680 680 680 680 680 680 680 680 680 680
680 680 680 680 680 680 680 680 680 680 680 680 680 680 680 680 680 680 680 680 680 680 680 680 680 680 680 680 680 680 680 680 680 680 680 680 680 680 680 680 680 680 680 680 680 680 680 680
680 680 680 680 680 680 680 680 680 680 680 680 680 680 680 680 680 680 680 680 680 680 680 680 680 680 680 680 680 680 680 680 680 680 680 680 680 680 680 680 680 680 680 680 680 680 680 680
680 680 680 680 680 680 680 680 680 680 680 680 680 680 680 680 680 680 680 680 680 680 680 680 680 680 680 680 680 680 680 680 680 680 680 680 680 680 680 680 680 680 680 680 680 680 680 680
680 680 680 680 680 680 680 680 680 680 680 680 680 680 680 680 680 680 680 680 680 680 680 680 680 680 680 680 680 680 680 680 680 680 680 680 680 680 680 680 680 680 680 680 680 680 680 680
680 680 680 680 680 680 680 680 680 680 680 680 680 680 680 680 680 713 713 713 713 713 713 713 713 713 713 713 713 680 680 680 680 680 680 680 680 680 680 680 680 680 680 680 680 680 680 680
680 680 680 680 680 680 680 680 680 680 680 680 680 680 680 680 680 713 1221 1221 1221 1221 1221 1221 1221 1223 1224 1221 713 680 680 680 680 680 680 680 680 680 680 680 680 680 680 680 680 680 680 680
680 680 680 680 680 680 680 680 680 680 680 680 680 680 680 680 680 713 1222 1225 1226 1222 1225 1226 1222 1227 1228 1222 713 680 680 680 680 680 680 680 680 680 680 680 680 680 680 680 680 680 680 680
680 680 680 680 680 680 680 680 680 680 680 680 680 680 680 680 680 713 1240 1229 1230 1240 1229 1230 1240 1231 1232 1240 713 680 680 680 680 680 680 680 680 680 680 680 680 680 680 680 680 680 680 680
680 680 680 680 680 680 680 680 680 680 680 680 680 680 680 680 680 713 1240 1233 1234 1240 1233 1234 1240 1235 1236 1240 713 680 680 680 680 680 680 680 680 680 680 680 680 680 680 680 680 680 680 680
680 680 680 680 680 680 680 680 680 680 680 680 680 680 680 680 680 713 1240 1240 1240 1240 1240 1240 1237 1240 1237 1240 713 680 680 680 680 680 680 680 680 680 680 680 680 680 680 680 680 680 680 680
680 680 680 680 680 680 680 680 680 680 680 680 680 680 680 680 680 713 1240 1238 1239 1241 1240 1240 1248 1240 1248 1240 713 680 680 680 680 680 680 680 680 680 680 680 680 680 680 680 680 680 680 680
680 680 680 680 680 680 680 680 680 680 680 680 680 680 680 680 680 713 1240 1242 1243 1244 1240 1240 1249 1240 1249 1240 713 680 680 680 680 680 680 680 680 680 680 680 680 680 680 680 680 680 680 680
680 680 680 680 680 680 680 680 680 680 680 680 680 680 680 680 680 713 1240 1245 1246 1247 1240 1240 1240 1240 1240 1240 713 680 680 680 680 680 680 680 680 680 680 680 680 680 680 680 680 680 680 680
680 680 680 680 680 680 680 680 680 680 680 680 680 680 680 680 680 713 1240 1240 1240 1240 1240 1240 1240 1240 1240 1240 713 680 680 680 680 680 680 680 680 680 680 680 680 680 680 680 680 680 680 680
680 680 680 680 680 680 680 680 680 680 680 680 680 680 680 680 680 713 1240 1240 1240 1240 679 679 1240 1240 1240 1240 713 680 680 680 680 680 680 680 680 680 680 680 680 680 680 680 680 680 680 680
680 680 680 680 680 680 680 680 680 680 680 680 680 680 680 680 680 713 713 713 713 713 713 713 713 713 713 713 713 713 713 680 680 680 680 680 680 680 680 680 680 680 680 680 680 680 680 680 680 680
680 680 680 680 680 680 680 680 680 680 680 680 680 680 680 680 680 713 713 713 713 713 713 713 713 713 713 713 713 713 713 680 680 680 680 680 680 680 680 680 680 680 680 680 680 680 680 680
680 680 680 680 680 680 680 680 680 680 680 680 680 680 680 680 680 713 713 713 713 713 713 713 713 713 713 713 713 680 680 680 680 680 680 680 680 680 680 680 680 680 680 680 680 680 680 680
680 680 680 680 680 680 680 680 680 680 680 680 680 680 680 680 680 680 680 680 680 680 680 680 680 680 680 680 680 680 680 680 680 680 680 680 680 680 680 680 680 680 680 680 680 680 680 680
680 680 680 680 680 680 680 680 680 680 680 680 680 680 680 680 680 680 680 680 680 680 680 680 680 680 680 680 680 680 680 680 680 680 680 680 680 680 680 680 680 680 680 680 680 680 680 680
680 680 680 680 680 680 680 680 680 680 680 680 680 680 680 680 680 680 680 680 680 680 680 680 680 680 680 680 680 680 680 680 680 680 680 680 680 680 680 680 680 680 680 680 680 680 680 680
680 680 680 680 680 680 680 680 680 680 680 680 680 680 680 680 680 680 680 680 680 680 680 680 680 680 680 680 680 680 680 680 680 680 680 680 680 680 680 680 680 680 680 680 680 680 680 680
680 680 680 680 680 680 680 680 680 680 680 680 680 680 680 680 680 680 680 680 680 680 680 680 680 680 680 680 680 680 680 680 680 680 680 680 680 680 680 680 680 680 680 680 680 680 680 680
680 680 680 680 680 680 680 680 680 680 680 680 680 680 680 680 680 680 680 680 680 680 680 680 680 680 680 680 680 680 680 680 680 680 680 680 680 680 680 680 680 680 680 680 680 680 680 680
680 680 680 680 680 680 680 680 680 680 680 680 680 680 680 680 680 680 680 680 680 680 680 680 680 680 680 680 680 680 680 680 680 680 680 680 680 680 680 680 680 680 680 680 680 680 680 680
680 680 680 680 680 680 680 680 680 680 680 680 680 680 680 680 680 680 680 680 680 680 680 680 680 680 680 680 680 680 680 680 680 680 680 680 680 680 680 680 680 680 680 680 680 680 680 680
680 680 680 680 680 680 680 680 680 680 680 680 680 680 680 680 680 680 680 680 680 680 680 680 680 680 680 680 680 680 680 680 680 680 680 680 680 680 680 680 680 680 680 680 680 680 680 680
680 680 680 680 680 680 680 680 680 680 680 680 680 680 680 680 680 680 680 680 680 680 680 680 680 680 680 680 680 680 680 680 680 680 680 680 680 680 680 680 680 680 680 680 680 680 680 680
